1 1 1 1 1 1 1 1 1 1 1 1 1 1 1 1 1 1 1 1 1 1 1 1 1 1 1 1 1 1 1 1 1 1 1 1 1 1 1 1 1 1 1 1 1 1 1 1 1 1 
1 1 1 1 1 1 1 1 1 1 1 1 1 1 1 1 1 1 1 1 1 1 1 1 1 1 1 1 1 1 1 1 1 1 15 15 15 15 15 15 15 15 15 15 15 1 15 15 1 1 
1 1 1 1 1 1 1 1 15 1 1 15 15 16 16 16 16 16 16 15 15 1 1 1 15 15 15 15 15 1 1 1 1 15 15 15 1 1 15 15 15 1 15 15 15 1 1 15 1 1 
1 1 1 1 1 1 1 15 15 15 1 1 1 15 16 16 16 16 16 16 15 1 1 15 15 15 15 15 15 1 1 1 1 15 15 15 1 1 15 15 15 15 15 15 15 15 15 15 1 1 
1 1 1 1 1 1 15 15 15 15 15 1 1 1 15 16 16 16 16 16 15 1 1 15 15 15 15 15 15 1 1 1 1 15 15 15 1 15 15 15 15 15 15 15 15 15 15 15 1 1 
1 1 1 1 1 15 15 15 15 15 15 15 1 1 1 15 16 16 16 15 1 1 1 15 15 15 15 15 15 1 1 1 15 15 15 15 15 15 15 15 15 15 15 15 15 15 15 15 1 1 
1 1 1 1 1 15 15 15 15 15 15 15 15 1 1 15 15 15 15 1 1 15 15 15 15 15 15 15 15 1 1 15 15 15 15 15 15 15 15 15 1 1 1 15 15 15 1 1 1 15 
1 1 1 1 1 15 15 15 15 15 15 15 15 15 15 15 15 15 1 1 15 15 15 15 15 15 15 15 15 1 15 15 15 15 15 15 15 15 15 15 15 1 15 15 1 13 14 1 15 15 
1 1 1 15 15 15 15 15 15 15 15 15 15 15 15 15 1 1 1 15 15 15 15 15 15 15 15 15 15 15 15 15 15 15 15 15 15 15 15 15 15 15 1 1 1 7 8 1 15 15 
1 1 15 15 15 15 15 15 15 15 15 15 15 15 15 1 1 15 15 15 15 15 15 15 15 15 15 15 15 15 15 15 15 15 15 1 1 1 1 1 1 1 1 1 1 7 8 1 15 15 
1 1 15 15 15 15 15 15 1 1 1 15 15 15 15 15 15 15 15 15 15 15 15 15 15 15 15 15 15 15 1 1 1 1 1 1 1 1 1 1 1 1 1 1 1 7 2 14 1 15 
1 1 15 15 15 15 15 1 1 1 1 1 1 15 15 15 15 15 15 15 1 1 1 1 1 1 1 1 1 1 1 1 1 1 1 1 1 1 1 1 1 1 1 1 1 7 2 8 1 15 
1 1 15 15 15 15 15 1 1 1 1 1 1 15 15 15 15 15 15 15 1 1 1 1 1 1 1 1 1 1 1 1 1 1 1 1 1 1 1 1 1 1 1 1 1 7 2 8 1 1 
1 1 15 15 15 15 15 1 1 1 1 1 1 1 15 15 15 15 15 15 15 15 15 15 15 15 15 15 15 15 15 15 1 1 1 1 1 1 1 1 1 1 1 1 15 7 2 8 1 1 
1 1 15 15 15 15 15 1 1 1 1 1 1 1 1 15 15 15 15 15 15 15 15 15 15 15 15 16 16 16 16 15 15 1 1 1 1 1 1 1 1 1 1 1 15 7 2 8 1 1 
1 1 15 15 15 15 15 1 1 1 1 1 1 1 1 1 15 15 15 16 16 16 16 16 16 16 16 16 16 16 16 15 15 16 1 16 16 16 16 16 1 1 1 1 15 7 2 2 14 1 
1 1 15 15 15 15 15 15 1 1 1 15 1 1 1 1 1 15 16 16 16 16 16 16 16 16 16 16 16 16 16 16 16 16 16 16 16 16 16 16 16 16 1 1 15 7 2 2 8 1 
1 1 15 15 15 15 15 15 15 15 15 15 15 1 1 1 1 15 16 16 16 16 16 16 16 16 16 16 16 16 16 16 16 16 16 16 16 16 16 16 16 16 1 1 15 7 2 2 8 1 
1 1 15 15 15 15 15 15 15 15 15 15 15 15 1 1 1 15 16 16 16 16 16 16 16 16 16 16 16 16 16 16 16 16 16 16 16 1 1 16 16 1 1 1 15 7 2 2 8 1 
1 1 15 15 15 15 15 15 15 15 15 15 15 15 15 1 1 15 16 16 16 16 16 16 16 16 16 16 16 16 16 16 16 1 1 1 1 1 1 1 1 1 1 1 15 7 2 2 8 1 
1 1 15 15 15 15 15 15 18 18 18 18 15 15 15 15 1 1 15 16 16 16 16 16 16 16 16 16 16 16 16 16 16 1 1 15 15 15 15 15 15 15 15 15 15 7 2 2 8 1 
1 15 15 15 15 18 18 18 18 18 18 18 18 18 18 15 1 1 1 15 15 16 16 16 16 16 16 16 15 15 15 1 1 1 1 15 13 11 11 11 11 11 11 11 11 2 2 2 8 1 
1 15 15 15 15 18 18 19 18 18 19 18 18 18 18 15 15 15 1 1 1 1 1 1 15 15 15 15 15 15 15 1 1 1 1 15 7 2 10 10 10 10 10 10 10 2 2 10 5 1 
1 15 15 15 18 18 18 18 18 18 18 18 18 18 18 15 15 15 15 15 15 1 1 1 1 1 1 1 1 1 1 1 1 1 1 15 7 8 15 15 15 15 1 1 1 7 5 1 1 1 
1 15 15 18 18 18 18 18 18 18 18 18 19 18 18 15 15 15 15 15 15 13 14 15 15 15 15 15 15 15 15 15 15 15 15 15 7 8 15 1 1 1 1 15 1 9 1 1 1 1 
1 15 18 18 19 18 18 18 19 18 18 18 18 18 15 15 15 15 1 1 1 7 2 11 11 11 11 11 11 11 11 11 11 11 11 11 2 8 15 1 1 1 1 15 1 7 8 1 1 1 
1 15 18 18 18 18 18 18 18 18 18 18 18 18 15 15 15 15 1 1 1 4 10 10 10 2 2 10 10 10 10 10 10 10 10 10 10 5 15 1 1 1 15 15 1 7 8 1 1 1 
1 15 18 18 18 18 18 19 18 18 18 18 18 18 15 15 15 1 1 1 1 15 15 15 15 7 8 15 15 15 15 15 15 15 15 15 15 15 1 1 1 15 15 15 1 7 8 1 1 1 
1 15 18 18 18 19 18 18 18 18 18 18 18 15 15 15 15 1 1 1 1 1 1 1 15 7 8 15 1 1 1 1 1 1 1 1 1 1 1 1 15 15 1 15 1 7 8 1 1 1 
1 15 18 18 18 18 18 18 18 18 18 18 18 15 15 15 15 1 1 1 1 1 1 1 15 7 8 15 1 1 1 1 1 1 1 1 1 1 1 15 15 15 15 15 1 7 8 1 1 1 
1 15 15 18 18 18 19 18 18 18 19 18 18 15 15 15 15 15 15 15 1 1 1 1 15 7 8 15 1 1 1 1 1 1 1 1 1 15 15 15 1 1 15 15 1 7 8 1 1 1 
1 15 15 15 18 18 18 18 18 18 18 18 15 15 15 15 15 15 15 15 1 1 1 1 15 7 8 15 1 1 15 1 1 1 1 1 15 15 15 15 1 15 15 15 1 7 8 1 1 1 
1 1 15 15 15 18 18 18 18 18 18 15 15 15 15 1 1 1 1 1 1 1 1 1 15 7 8 15 1 1 15 15 15 1 1 1 15 1 15 15 15 15 15 1 1 7 8 1 1 1 
1 1 1 15 15 15 15 15 15 15 15 15 15 15 1 1 17 17 15 15 15 15 15 15 15 7 8 1 1 1 18 18 18 1 1 1 1 1 1 1 1 1 1 1 1 7 8 1 1 1 
1 1 1 1 15 15 15 15 15 15 15 15 15 15 1 17 17 13 11 11 11 11 11 11 11 2 8 1 1 18 18 18 18 1 13 11 11 11 11 11 11 11 11 11 11 2 8 1 1 1 
1 1 1 1 1 1 1 1 1 1 1 1 1 1 1 17 13 2 10 10 10 10 10 10 10 10 5 1 18 18 19 19 18 1 7 2 10 10 10 10 10 10 10 10 10 10 8 1 1 1 
17 17 17 17 17 17 17 17 17 17 17 17 17 17 17 17 16 16 17 17 17 1 1 1 1 1 1 18 19 18 18 18 15 1 7 8 1 1 1 1 1 1 1 1 1 1 9 1 1 1 
17 17 17 17 17 17 17 17 17 17 17 17 17 17 17 17 16 16 17 17 17 1 1 1 1 1 1 18 18 18 18 15 15 1 7 8 1 15 15 15 15 15 15 1 1 1 9 1 1 15 
17 16 16 16 16 16 16 16 16 16 16 16 16 16 16 16 16 16 17 17 17 1 1 1 1 1 15 18 18 19 18 15 15 1 7 8 1 15 1 15 1 15 15 15 1 1 9 1 15 15 
17 16 16 16 16 16 16 16 16 16 16 16 16 16 16 16 16 16 17 17 17 1 1 1 1 1 15 15 18 18 18 15 15 1 7 8 1 15 15 1 1 15 1 15 1 1 9 1 15 15 
17 16 16 16 16 16 16 16 16 17 17 17 17 17 17 17 17 17 17 17 17 1 1 1 1 1 15 15 15 15 15 15 15 1 7 8 1 15 15 15 1 15 15 15 1 1 9 1 15 15 
17 16 16 16 16 17 17 17 17 17 17 17 16 16 16 16 16 16 17 17 17 1 1 1 1 15 15 1 1 1 1 1 1 1 7 8 1 15 15 15 15 15 1 15 1 1 9 1 15 15 
17 16 16 16 17 17 17 17 17 17 17 17 16 16 16 16 16 16 17 17 17 1 1 1 15 15 15 15 15 13 11 11 11 11 2 8 1 15 1 15 15 15 15 15 1 1 9 1 15 15 
17 16 16 16 17 17 17 17 17 17 17 17 16 16 17 17 16 16 17 17 17 1 1 15 15 15 15 15 12 10 10 10 10 10 10 5 1 15 15 15 15 15 1 17 17 17 16 17 17 1 
17 16 16 16 17 17 17 17 17 17 17 16 16 16 17 17 16 16 17 17 17 1 15 15 15 1 1 1 1 1 1 1 1 1 1 1 1 15 18 18 15 15 1 17 16 16 16 16 17 1 
17 16 16 16 17 17 17 17 17 17 17 16 16 16 17 17 16 16 17 17 17 15 15 15 1 1 1 1 1 15 15 15 15 15 15 15 15 18 18 18 15 15 1 17 16 16 16 16 17 1 
17 16 16 16 17 17 17 17 16 16 16 16 16 16 17 17 16 16 16 17 17 15 15 1 1 1 1 1 1 15 15 15 18 18 18 18 18 18 19 19 18 15 1 17 16 16 17 16 17 1 
17 16 16 16 16 16 16 16 16 16 16 16 16 16 17 17 16 16 16 16 16 15 15 1 1 1 1 1 1 15 15 18 18 18 18 18 19 18 18 18 18 15 1 17 16 16 17 16 17 1 
17 16 16 16 16 16 16 16 16 16 16 16 16 16 17 17 16 16 16 16 17 1 1 1 1 1 1 1 1 15 18 18 18 19 18 18 18 18 18 19 18 15 1 17 17 17 17 17 17 1 
17 17 17 17 17 17 17 17 17 17 17 17 17 17 17 17 17 17 17 17 17 15 1 1 1 1 1 15 15 18 18 19 18 18 18 18 18 18 18 18 18 15 1 1 1 1 1 1 1 1 
